#Asia
ALS	= "countries/Asia.txt"	#アラスカ
AMR	= "countries/Asia.txt"	#アムール
ARK	= "countries/Asia.txt"	#アラカン
BRN	= "countries/Asia.txt"	#ブルネイ
CHN	= "countries/Asia.txt"	#チン
COK	= "countries/Asia.txt"	#クック
EHB	= "countries/Asia.txt"	#冀東
ETR	= "countries/Asia.txt"	#東トルキスタン
EVN	= "countries/Asia.txt"	#エヴェンキ
EZO	= "countries/Asia.txt"	#蝦夷
FUJ	= "countries/Asia.txt"	#福建
GND	= "countries/Asia.txt"	#広東
GOA	= "countries/Asia.txt"	#ゴア
HKG	= "countries/Asia.txt"	#香港
HYD	= "countries/Asia.txt"	#ハイデラバード
INC	= "countries/Asia.txt"	#インドシナ
INO	= "countries/Asia.txt"	#インド洋
IRK	= "countries/Asia.txt"	#イルクーツク
JNA	= "countries/Asia.txt"	#ジュナーガド
KAC	= "countries/Asia.txt"	#カチン
KAM	= "countries/Asia.txt"	#カムチャッカ
KAS	= "countries/Asia.txt"	#カシミール
KAY	= "countries/Asia.txt"	#カヤー
KHB	= "countries/Asia.txt"	#ハバロフスク
KHM	= "countries/Asia.txt"	#カム
KIR	= "countries/Asia.txt"	#キリバス
KMV	= "countries/Asia.txt"	#ケメロヴォ
KRE	= "countries/Asia.txt"	#カレン
KRS	= "countries/Asia.txt"	#クラスノヤルスク
KUM	= "countries/Asia.txt"	#クムル
MCA	= "countries/Asia.txt"	#澳門
MHL	= "countries/Asia.txt"	#マーシャル
MWN	= "countries/Asia.txt"	#モン
MYS	= "countries/Asia.txt"	#マイソール
NCL	= "countries/Asia.txt"	#ニューカレドニア
NGL	= "countries/Asia.txt"	#ナガランド
NIU	= "countries/Asia.txt"	#ニウエ
NMR	= "countries/Asia.txt"	#ナウル
NSB	= "countries/Asia.txt"	#ノヴォシビルスク
OMS	= "countries/Asia.txt"	#オムスク
PAO	= "countries/Asia.txt"	#太平洋
PLW	= "countries/Asia.txt"	#パラオ
RYU	= "countries/Asia.txt"	#琉球
SCC	= "countries/Asia.txt"	#南コーカサス
SCH	= "countries/Asia.txt"	#四川
SGH	= "countries/Asia.txt"	#上海
SHN	= "countries/Asia.txt"	#シャン
SIB	= "countries/Asia.txt"	#シベリア
SIN	= "countries/Asia.txt"	#シンガポール
SKM	= "countries/Asia.txt"	#シッキム
SRW	= "countries/Asia.txt"	#サラワク
TAI	= "countries/Asia.txt"	#タイ
TKY	= "countries/Asia.txt"	#東京
TLS	= "countries/Asia.txt"	#東ティモール
TOK	= "countries/Asia.txt"	#トンキン
TON	= "countries/Asia.txt"	#トンガ
TRK	= "countries/Asia.txt"	#トルキスタン
TRV	= "countries/Asia.txt"	#トラヴァンコール
TSK	= "countries/Asia.txt"	#トムスク
TVL	= "countries/Asia.txt"	#ツバル
TWN	= "countries/Asia.txt"	#台湾
TYU	= "countries/Asia.txt"	#チュメニ
VUT	= "countries/Asia.txt"	#バヌアツ
WPO	= "countries/Asia.txt"	#西太平洋
WTR	= "countries/Asia.txt"	#西トルキスタン

#Middle East
BHR	= "countries/Middle East.txt"	#バーレーン
HEZ	= "countries/Middle East.txt"	#ヒジャーズ
JRS	= "countries/Middle East.txt"	#エルサレム
MSC	= "countries/Middle East.txt"	#マスカット
SCZ	= "countries/Middle East.txt"	#スエズ運河

#Commonwealth
NEL	= "countries/Commonwealth.txt"	#ニューイングランド
NFL	= "countries/Commonwealth.txt"	#ニューファンドランド

#Western Europe
ADR	= "countries/Western Europe.txt"	#アンドラ
AKS	= "countries/Western Europe.txt"	#アーカンソー
ARA	= "countries/Western Europe.txt"	#アラゴン
ATR	= "countries/Western Europe.txt"	#アストゥリアス
BLE	= "countries/Western Europe.txt"	#バレアレス
BRG	= "countries/Western Europe.txt"	#ブルゴーニュ
BSQ	= "countries/Western Europe.txt"	#バスク
CAL	= "countries/Western Europe.txt"	#カリフォルニア
CNA	= "countries/Western Europe.txt"	#カナリア
COW	= "countries/Western Europe.txt"	#コーンウォール
CSC	= "countries/Western Europe.txt"	#カスカディア
CTB	= "countries/Western Europe.txt"	#カンタブリア
DAL	= "countries/Western Europe.txt"	#ダルマチア
EXT	= "countries/Western Europe.txt"	#エストレマドゥーラ
FLN	= "countries/Western Europe.txt"	#フランドル
FLO	= "countries/Western Europe.txt"	#フロリダ
FRO	= "countries/Western Europe.txt"	#フェロー
GAL	= "countries/Western Europe.txt"	#ガリツィア
GBR	= "countries/Western Europe.txt"	#グレートブリテン
GIB	= "countries/Western Europe.txt"	#ジブラルタル
GRL	= "countries/Western Europe.txt"	#グリーンランド
IBE	= "countries/Western Europe.txt"	#イベリア
LIE	= "countries/Western Europe.txt"	#リヒテンシュタイン
LMN	= "countries/Western Europe.txt"	#ラ・マンチャ
LON	= "countries/Western Europe.txt"	#レオン
LRJ	= "countries/Western Europe.txt"	#ラ・リオハ
LUI	= "countries/Western Europe.txt"	#ルイジアナ
MCO	= "countries/Western Europe.txt"	#モナコ
MDR	= "countries/Western Europe.txt"	#マドリード
MUR	= "countries/Western Europe.txt"	#ムルシア
NJE	= "countries/Western Europe.txt"	#ニュージャージー
NTL	= "countries/Western Europe.txt"	#ネーデルラント
OKL	= "countries/Western Europe.txt"	#オクラホマ
PEN	= "countries/Western Europe.txt"	#ペンシルバニア
POI	= "countries/Western Europe.txt"	#ポワトゥー
PRV	= "countries/Western Europe.txt"	#プロヴァンス
QEB	= "countries/Western Europe.txt"	#ケベック
SCA	= "countries/Western Europe.txt"	#スカンディナヴィア
SME	= "countries/Western Europe.txt"	#サーミランド
SMR	= "countries/Western Europe.txt"	#サンマリノ
TEU	= "countries/Western Europe.txt"	#チュートン
TEX	= "countries/Western Europe.txt"	#テキサス
VAL	= "countries/Western Europe.txt"	#バレンシア
WLL	= "countries/Western Europe.txt"	#ワロン

#Eastern Europe
ADY	= "countries/Eastern Europe.txt"	#アディゲ
BLK	= "countries/Eastern Europe.txt"	#バルカン
BLT	= "countries/Eastern Europe.txt"	#バルト
CCS	= "countries/Eastern Europe.txt"	#コーカサス
CHE	= "countries/Eastern Europe.txt"	#チェチェン
ING	= "countries/Eastern Europe.txt"	#イングーシ
INT	= "countries/Eastern Europe.txt"	#インテルマリウム
KRC	= "countries/Eastern Europe.txt"	#カラチャイ
KRV	= "countries/Eastern Europe.txt"	#キーロフ
LIV	= "countries/Eastern Europe.txt"	#リヴォニア
LMK	= "countries/Eastern Europe.txt"	#レムコ
MOS	= "countries/Eastern Europe.txt"	#モスクワ
MRD	= "countries/Eastern Europe.txt"	#モルドヴィア
ORB	= "countries/Eastern Europe.txt"	#オレンブルグ
PAT	= "countries/Eastern Europe.txt"	#総主教領
PET	= "countries/Eastern Europe.txt"	#ペテルブルク
PRM	= "countries/Eastern Europe.txt"	#ペルミ
RTN	= "countries/Eastern Europe.txt"	#ルテニア
RUS	= "countries/Eastern Europe.txt"	#ロシア
SMA	= "countries/Eastern Europe.txt"	#サマラ
SOA	= "countries/Eastern Europe.txt"	#南オセチア
TRN	= "countries/Eastern Europe.txt"	#トランスニストリア
ULY	= "countries/Eastern Europe.txt"	#ウリヤノフスク
URA	= "countries/Eastern Europe.txt"	#ウラル
VOJ	= "countries/Eastern Europe.txt"	#ヴォイヴォディナ
WLC	= "countries/Eastern Europe.txt"	#ワラキア
ZPR	= "countries/Eastern Europe.txt"	#ザポロージャ

#Africa
AFR	= "countries/Africa.txt"	#アフリカ
COM	= "countries/Africa.txt"	#コモロ
CPV	= "countries/Africa.txt"	#カーボベルデ
EQA	= "countries/Africa.txt"	#赤道アフリカ
KLE	= "countries/Africa.txt"	#カレンジン
LSO	= "countries/Africa.txt"	#レソト
MAF	= "countries/Africa.txt"	#中部アフリカ
MUS	= "countries/Africa.txt"	#モーリシャス
MWA	= "countries/Africa.txt"	#ムワミ
NAF	= "countries/Africa.txt"	#北アフリカ
OUB	= "countries/Africa.txt"	#ウバンギ
RHO	= "countries/Africa.txt"	#ローデシア
RMN	= "countries/Africa.txt"	#鉱山
SAH	= "countries/Africa.txt"	#サハラ
SML	= "countries/Africa.txt"	#ソマリランド
SSD	= "countries/Africa.txt"	#南スーダン
STP	= "countries/Africa.txt"	#サントメ・プリンシペ
SWL	= "countries/Africa.txt"	#スワジランド
SYC	= "countries/Africa.txt"	#セーシェル
TAN	= "countries/Africa.txt"	#タンガニーカ
UEL	= "countries/Africa.txt"	#ウエレ
WAF	= "countries/Africa.txt"	#西アフリカ
ZAN	= "countries/Africa.txt"	#ザンジバル

#South America
ATG	= "countries/South America.txt"	#アンティグア
BRB	= "countries/South America.txt"	#バルバドス
CEN	= "countries/South America.txt"	#中央アメリカ
DMA	= "countries/South America.txt"	#ドミニカ
GRD	= "countries/South America.txt"	#グレナダ
KNA	= "countries/South America.txt"	#セントクリストファー・ネビス
PCZ	= "countries/South America.txt"	#パナマ運河
SAC	= "countries/South America.txt"	#南アメリカ
SLC	= "countries/South America.txt"	#セントルシア
VCT	= "countries/South America.txt"	#セントビンセント・グレナディーン
